7 8
S##.##.#
........
#.####.#
#.####.#
#.####..
#.#..#.#
#..G...#
